20 20
####################
#P   #      T     S#
### ### ######### ##
#             #   ##
# ### ##### # # ####
#   #     # # #    #
### ##### # # #### #
#     #   # #    # #
##### # ### #### # #
#   # #   #    # # #
# # # ### #### # # #
# # #   #    # #   #
# # ### #### # #####
# #   #      #     #
# ### ########### ##
#   #     T       ##
### ####### #######
#       A        ##
####################