12 12
############
#P#       S#
# # ###### #
# #  T   # #
# ###### # #
#        # #
########## #
#          #
# ##########
#          #
# ##########
############