20 20
####################
#P   #   T    #    #
### ### ###### # # #
#     #      # # # #
# ##### #### # # # #
#   T #    # # #   #
##### #### # # #####
#   #    # # #     #
# # #### # # ##### #
# #   T  # #     # #
# ######## ##### # #
#   T    #     # # #
######## # ### # # #
#      # # #   #   #
# #### # # # #######
#    # # # #   A   #
# ## # # # ####### #
#  #   #   #     # #
#  ####### # ### #S#
####################