20 20
####################
#    #      T     S#
### ### ######### ##
#             # T ##
# ### ##### # # ####
#   #     # # #    #
### ##### # # #### #
#     #  T# #    # #
##### # ### #### # #
#   # #   #    # # #
# # # ### #### # # #
# # #   #    # #   #
# # ### #### # #####
# #   #      #     #
# ### ########### ##
#   #     T       ##
### ####### ########
##P      A        ##
####################