20 20
####################
#    #      T     S#
### ### ######### ##
#             #   ##
# ### ##### # # ####
#   #     # # #    #
### ##### # # #### #
#     #   # #    # #
##### # ### #### # #
#   # #   #    # # #
# # # ### #### # # #
# # #   #    # #   #
# # ### #### # #####
# #   #      #     #
# ### ########### ##
#   #     T       ##
### ####### ########
##       A        ##
####################